6AAAAAEAAC0000006AAAC0000006AAEAAAAAC
500000500506AAEAD0007AEAAC05005000005
506AEABC0505005050005050050506BAEAC05
5050500505050050500050500505050050505
7AD0500507AD06BABAAABABC07AD0500507AD
50503AAD0505050000500005050507AA90505
5050000505050506EEFEEC050505050000505
507AAAABAD050507FFFFFD050507ABAAAAD05
505000000507AD07FFFFFD07AD05000000505
50506AAC05050507FFFFFD05050506AAC0505
5050500505050503BBBBB9050505050050505
507AD007AFA905000000000503AFAD007AD05
50505005050007AAAAEAAAAD0005050050505
50503AA90506A90000500003AC0503AA90505
5050000005050006AABAAC000505000000505
507AEAAAAD0506A9000003AC0507AEAAAAD05
5050500005050500000000050505050000505
50507AAC050507AEAAAAAEAD050507AAC0505
5050500507AD05050000050507AD050050505
5050500505050505000005050505050050505
50503AAD05050503AAEAA905050503AAD0505
5050000505050500005000050505000050505
507AAAABA907ABAAAABAAAABAD03AAAABAD05
5050000000050000000000000500000000505
3ABAAAAAAAA900000000000003AAAAAAAABA9