6AAAAAEAAC0000006AAAC0000006AAEAAAAAC
500000500506AAEAD0007AEAAC05005000005
506AEAAC0505005050005050050506AAEAC05
5050500505050050500050500505050050505
7AD0500507AD06BABAAABABC07AD0500507AD
50503AAD0505050000F00005050507AAA0505
505000050505050FFFFFFF050505050000505
507AAAABAD05050FFFFFFF050507AAAAAAD05
505000000507AD0FFFFFFF07AD05000000505
50506AAC0505050FFFFFFF05050506AAC0505
505050050505050FFFFFFF050505050050505
507AD007AFA905000000000503AFAD007AD05
50505005050007AAAAEAAAAD0005050050505
50503AA90506A90000500003AC0503AA90505
5050000005050006AABAA3000505000000505
507AEAAAAD0506590000035C0507AEAAAAD05
5050500005050500000000050505050000505
50507AAC050507AEAAAAAEAD050507AAC0505
5050500507AD05050000050507AD050050505
5050500505050505000005050505050050505
50503AAD05050503AAEAA905050503AAD0505
5050000505050500005000050505000050505
507AAAABA604ABAAAABAAAABAD03AAAABAD05
5050000000050000000000000500000000505
3ABAAAAAAAA900000000000003AAAAAAAABA9