1111111111000000111110000001111111111
1000001001011111100011111101001000001
1011111101010010100010100101011111101
1010100101010010100010100101010010101
1110100101110111111111110111010010111
1010211101010100008000010101011120101
1010000101010108888888010101010000101
1011111111010108888888010101111111101
1010000001011108888888011101000000101
1010111101010108888888010101011110101
1010100101010108888888010101010010101
1011100111110100000000010111110011101
1010100101000111111111110001010010101
1010111101011100001000011101011110101
1010000001010001111111000101000000101
1011111111010111000001110101111111101
1010100001010100000000010101010000101
1010111101010111111111110101011110101
1010100101110101000001010111010010101
1010100101011101000001010101010010101
1010111101010101111111010101011110101
1010000101010100001000010101000010101
1011111112011111111111111102111111101
1010000000010000000000000100000000101
1111111111110000000000000111111111111